{
  "ກ": 0,
  "ຂ": 1,
  "ຄ": 2,
  "ງ": 3,
  "ຈ": 4,
  "ຊ": 5,
  "ຍ": 6,
  "ດ": 7,
  "ຕ": 8,
  "ຖ": 9,
  "ທ": 10,
  "ນ": 11,
  "ບ": 12,
  "ປ": 13,
  "ຜ": 14,
  "ຝ": 15,
  "ພ": 16,
  "ຟ": 17,
  "ມ": 18,
  "ຢ": 19,
  "ລ": 20,
  "ວ": 21,
  "ສ": 22,
  "ຫ": 23,
  "ອ": 24,
  "ຮ": 25,
  "ະ": 26,
  "ັ": 27,
  "າ": 28,
  "ິ": 29,
  "ີ": 30,
  "ຶ": 31,
  "ື": 32,
  "ຸ": 33,
  "ູ": 34,
  "ົ": 35,
  "ຽ": 36,
  "ເ": 37,
  "ໂ": 38,
  "ໃ": 39,
  "ໄ": 40,
  "່": 41,
  "້": 42,
  "ໍ": 43
}